Task 1
Примеры:
Сера
Порядковый номер четный - да
Период четный - нет
Группа четная - да
Название элемента длиннее 4 символов (5 и более) - нет
Название элемента имеет букву й или ь - нет
В относительной атомной массе есть 9 - нет
Дробная часть атомной массы длинее 2 символов (3 и более) - да
Целая часть атомной массы длинее 2 символов (3 и более) - нет

Иттрий - нет, нет, нет, да, да, да, да, нет
Литий - нет, да, нет, да, да, да, да, нет
Бор - нет, да, нет, нет, нет, нет, да, нет
Углерод - да, да, да, да, нет, нет, да, нет
Криптон - да, да, да, да, нет, нет, нет, нет
Никель - да, да, да, да, да, нет, нет, нет
Водород - нет, нет, нет, да, нет, да, да, нет
Кремний - да, нет, да, да, да, нет, да, нет
Марганец - нет, да, нет, да, нет, да, да, нет
Индий - нет, нет, нет, да, да, нет, нет, да
Астат - нет, да, нет, да, нет, да, нет, да
Серебро - нет, нет, нет, да, нет, нет, да, да
Золото - нет, да, нет, да, нет, да, да, да
Олово - да, нет, да, да, нет, нет, нет, да
Берилий - да, да, да, да, да, да, да, нет


Task 2
Натуральные - используемые при счете
Целые
рациональные - дробь (целое/натуральное)
вещественное - любое на числовой прямой
комплексное - число, вида a+bi (a,b - вещественные)
четные
нечетные
простые - натуральное положительное число, имеющее 2 делителя (себя и единицу)

1,2,3,4,5,6,7,8,9,10,-1,-2,-3,1.1,1/2,2i


Task 3
Пузырьковая сортировка - менять местами соседние элементы до талого - самая простая и одна из самых не стабильных (а значит и медленных) (от O(n^2) до O(n))
Гномья сортировка - лучше работает на частично отсортированном массиве (от O(n^2) до O(n))
Блочная сортировка - - от O(n^2) до O(n)
Пирамидальная сортировка - использует бинарное сортирующее дерево.
+: стабильно выдающая O(n*log(n)) операций, а память O(1)
-: не имеет разницы в обработке почти отсортированных и хаотичных массивах,
Неустойчив — для обеспечения устойчивости нужно расширять ключ.
На одном шаге выборку приходится делать хаотично по всей длине массива — поэтому алгоритм плохо сочетается с кэшированием и подкачкой памяти.
Методу требуется «мгновенный» прямой доступ; не работает на связанных списках и других структурах памяти последовательного доступа.
Не распараллеливается.

Task 6
Квадрат матрицы - умножение ее себя на себя, она должна быть квадратной
Транспонирование - поворот (столбцы и строки поменять местами), транспонировать можно любые матрицы